  "##########"
  "#.BM...M.#"
  "#..##....#"
  "#........#"
  "#....##B.#"
  "#.M......#"
  "#..##....#"
  "#..B.....#"
  "#........#"
  "#....##..#"
  "#........#"
  "#..##....#"
  "#..B.....#"
  "#........#"
  "#....##..#"
  "#.M......#"
  "#..##..B.#"
  "#........#"
  "#....M...#"
  "##########"