  "##########"
  "#.BM.....#"
  "#..##....#"
  "#........#"
  "#....##B.#"
  "#........#"
  "#..##....#"
  "#..B.....#"
  "#........#"
  "#....##..#"
  "#........#"
  "#..##....#"
  "#..B.....#"
  "#........#"
  "#....##..#"
  "#........#"
  "#..##..B.#"
  "#........#"
  "#....M...#"
  "##########"